#######
#P    #
#X   O#
#     #
#######